ABC	ABC
AIDG	AIDG
AIDS	AIDS
ALS	肌萎缩性侧索硬化症
AOL	AOL
API	API
ARPA	高级研究计划署
Aaron	亚伦
Abdul	阿布杜
Abigail	阿比盖尔
Absolutely	绝对的
Access	Access
Actor	执行者
Adam	亚当
Adams	Adams
Adapt	随时调整适应
Adit	Adit
Adorable	粉可爱
Adria	Adria
Africa	Africa
Agnes	Agnes
Aguera	Aguera
Ahmad	Ahmad
Ahn	安
Aicha	艾莎
Aida	阿依达
Aimee	艾米
Alan	Alan
Alan	阿兰
Albrecht	Albrecht
Alex	Alex
Alex	亚历克斯
Alexander	Alexander
Alexander	亚历山大
Ali	Ali
Ali	阿里
Alison	艾莉森
Allan	Allan
Alliance	文明战线
Ally	Ally
Alpha	Alpha
Alps	阿尔卑斯山
Alwar	Alwar
Amanda	阿曼达
Amber	凯斯Amber
Ambulance	Ambulance
Amnesty	特赦
Amory	Amory
Amy	Amy
Amy	艾米
Anand	Anand
Ananthaswamy	Ananthaswamy
Anderson	Anderson
Anderson	安德森
Andreas	Andreas
Andrew	Andrew
Andy	Andy
Andy	安迪
Angela	Angela
Anghiari	安吉亚里之战
Angola	安哥拉
Angrigami	愤怒纸
Anil	Anil
AnnMarie	安玛丽
Anna	Anna
Anna	安娜
Annie	安妮
Anonymous	匿名者
Answers	所有的答案
Antarctica	南极洲
Anthony	Anthony
Anthony	安东尼
Anthropocene	人类世
Antoine	安东尼
Antonelli	保拉
Anyway	总之
Apocalypse	现代启示录
Apple	Apple
Architect	建筑师
Architect	我的建筑师
Arctic	北极
Are	Are
Argentina	阿根廷
Ariely	Ariely
Armstrong	Armstrong
Armstrong	Armstrong说
Arrhenius	Arrhenius
Arroyo	Arroyo
Art	艺术
Arthur	Arthur
Arunachalam	Arunachalam
Ashanti	非洲西部
Ashleigh	阿希利
Asia	Asia
Assange	Assange
Atheist	无神论者
Atlassian	Atlassian
Attitude	attitude
Audience	观众
Augmented	增强现实
Auret	希尔登Auret
Austin	Austin
Australia	澳大利亚
Authenticity	authenticity
Autonomy	自主性
Aye	明白
Ayelet	爱利特
Aylward	艾尔沃德
BOMB	BOMB
Baba	Baba
Baby	Baby
Baby	婴儿
Baby	宝宝
Baby	宝贝儿
Bacha	帕夏
Bagel	Bagel
Bagels	百吉饼
Baker	Baker
Balakrishnan	生命之空
Balasubramaniam	Balasubramaniam
Bangalore	班加罗尔
Banjo	Banjo
Baraniuk	Baraniuk
Barbara	芭芭拉
Baril	Baril
Barry	Barry
Bart	Bart
Bart	巴特
Barón	Barón
Basin	Basin
Basingstoke	贝辛斯托克
Beau	Beau
Beautiful	美丽
Bee	蜂
Behar	Behar
Bell	Bell
Bellows	Bellows
Ben	本
Benjamin	本杰明
Bennett	Bennett
Berkeley	伯克利
Berkley	Berkley
Bertrand	Bertrand
Bess	Bess
Bess	贝斯
Best	Best
Beth	Beth
Betty	贝蒂
Beverly	Beverly
Bezos	Bezos
Big	Big
Bill	Bill
Bill	比尔
Billy	比利
Bing	叮
Bioenergy	生物能源
Bir	Bir
Birth	从受孕至出生
Blakley	Blakley
Bless	保佑你
Blood	血流成河
Blue	蓝色
Boahen	Boahen
Boaz	Boaz
Bob	Bob
Bob	鲍勃
Bollywood	宝莱坞
Bono	Bono
Bono	博诺
Bono	波诺
Boone	Boone
Bora	Bora
Born	出生地伊朗
Bose	波色
Boy	男孩
Boyle	Boyle
Brand	Brand
Brazil	巴西
Bread	面包
Breazeal	布雷齐尔
Brent	布伦特
Brett	伯瑞特
Brian	Brian
Brian	布莱恩
Brooks	布鲁克斯
Brown	Brown
Brown	布朗
Browne	布朗
Bruce	布鲁斯
Bruno	Bruno
Bruno	布鲁诺
Buba	Buba
Buckminster	Buckminster
Budapest	布达佩斯
Buddhism	Buddhism
Bundy	Bundy
Bush	布什
But	但是
Bye	再见
Byrne	Byrne
CAD	CAD
CBS	CBS
CNN	CNN
CPU	中央处理器
CSI	犯罪现场调查
Caitria	Caitria
Cala	Cala
Cameron	卡梅隆
Camp	Camp
Cantor	Cantor
Caps	Cap
Carl	Carl
Carmen	卡门
Carne	卡恩
Carnival	嘉年华
Caroline	Caroline
Caroline	卡罗琳
Carolyn	Carolyn
Carson	Carson
Carter	Carter
Carter	卡特
Cascio	Cascio
Catherine	Catherine
Center	Center
Cesar	Cesar
Chadd	Chadd
Chaffer	Chaffer
Chanting	口号声
Chaos	Chaos
Chaos	混乱
Chapman	查普曼
Character	寻找美国符号
Charles	Charles
Charles	查尔斯
Charley	查莉
Charlie	Charlie
Charlie	查莉
Charlotte	夏洛特
Chatrou	查特尔
Cheap	便宜
Chef	厨师
Chen	Chen
Cheryl	Cheryl
Chevy	看那辆Chevy雪佛兰车
Chez	Chez
Chiat	Chiat
Child	Child
Child	孩子
Children	孩子们
Chile	智利
Chimpanzees	黑猩猩
Chip	奇普
Chitra	Chitra
Choir	合唱团
Chris	Chris
Chris	克里斯
Christakis	克里斯塔吉斯
Christianity	Christianity
Christians	基督徒
Christina	克里斯蒂娜
Christopher	Christopher
Christopher	克里斯托弗
Chu	Chu
Cindy	辛迪
Citron	Citron
Clare	Clare
Clare	克莱尔
Clarke	Clarke
Clonie	克隆
Cloud	云端学院
Cochrane	卡克伦
Cohen	Cohen
Collins	柯林斯
Commentator	评论
Compassion	同情心
Connery	康纳利
Conversely	相反地
Cooper	库珀
Copenhagen	哥本哈根
Corneille	Corneille
Corruption	腐败
Council	爸爸军团
Country	国家A
Country	郊外
Courage	勇气
Cousteau	雅克
Craig	Craig
Cuddy	Cuddy
Cupertino	库比蒂诺
Curitiba	库里蒂巴
Cute	不过不适合我们
Cynthia	Cynthia
Cynthia	辛西娅
DARPA	DARPA
DARwIn	DARwIn
DATA	DATA
DDT	DDT
DNA	DNA
Dad	爸
Dad	爸爸
Daddy	爸爸
Daisy	雏菊
Daisy	黛西
Dale	戴尔
Dallas	达拉斯
Damn	该死
Damon	达蒙
Dan	Dan
Dan	丹
Dana	丹娜
Daniel	Daniel
Daniel	丹尼尔
Danny	Danny
Daphne	Daphne
Daphne	达芙妮
Darfur	达尔富尔
Data	Data
Data	数据
Dave	Dave
Davenhall	Davenhall
David	David
David	大卫
Davidson	戴维森
Dawkins	Dawkins
Dead	已故之人
Dean	Dean
Dean	迪恩
Death	死神
Deavere	Deavere
Deb	戴
Debevec	德贝维奇
Deborah	Deborah
December	十二月
Democracy	民主
Demon	Demon
Dennett	Dennett
Dennis	Dennis
Dereck	Dereck
Derek	德里克
Descartes	笛卡尔
Detail	细节
Determination	决心就好像
Dhani	达尼
Diabetes	糖尿病
Diamonds	方块
Diana	戴安娜
Diane	黛安
Dicke	Dicke马赛
Dimitri	迪米特里
Dinosaurs	恐龙是因为小行星撞击地球而灭绝的
Disney	迪士尼
Djabran	吉布仑
Doctor	医生
Doctor	博士
Doctor	大夫
Dolby	Dolby
Dolby	多比
Donnell	Donnell
Doodlers	涂鸦者
Doris	Doris
Doris	多丽丝
Doug	Doug
Doug	道格
Dougherty	多尔蒂
Downs	当丝
Drew	Drew
Duke	杜克
Duncker	Duncker
Durga	杜尔迦女神
Dyan	黛安
Dysmorphophobia	曲影症
Dyson	Dyson
Dyson	戴森
EDL	EDL
Ebert	埃伯特
Economist	经济学人
Economist	经济学家
Edith	伊迪丝
Edmund	Edmund
Eduardo	Eduardo
Educational	兰迪教育基金会
Edward	Edward
Edward	爱德华
Edwards	爱德华兹
Egypt	埃及
Eight	八年后
Einstein	爱因斯坦
Eleanor	埃莉诺
Electricity	电
Eliasson	Eliasson
Elizabeth	Elizabeth
Elizabeth	伊丽莎白
Ellen	Ellen
Ellsey	Ellsey
Ellsey	埃尔西
Else	非战争事务部长
Embrace	温暖的拥抱
Emergence	涌现现象
Emily	Emily
Emmart	Emmart
Encyclopedia	生命百科
Engineer	工程师
Eno	Eno
Enough	够了
Enrico	Enrico
Ensler	Ensler
Entertainment	娱乐
Eric	Eric
Eric	埃里克
Eric	艾瑞克
Erica	艾丽卡
Ernst	Ernst
Esther	Esther
Etienne	艾蒂安
Eurotrash	欧洲滥人
Euvin	Euvin
Eva	伊娃
Evan	Evan
Eve	Eve
Eve	伊芙
Evelyn	Evelyn
Ewango	Ewango
Excellent	好极了
Ezra	伊斯梅尔
Fab	Fab
Facebook	Facebook
Falcon	猎鹰
Fantastic	好极了
Faron	Faron
Father	父亲
Featured	Featured
February	二月
FedEx	FedEx
Feiler	菲勒
Feki	Feki
Felix	Felix
Fellow	Fellow
Fellows	Fellows
Ferguson	费格森
Fermi	Fermi
Ferriss	费里斯
Feynman	费曼
Fifth	第五个男人
Finger	手指
Flowers	只有
Floyd	Floyd
Fluctus	富鲁克图斯
Fluctus	富鲁克鲁斯
Foods	Foods
Foreign	Foreign
Forget	放弃吧
Forrest	Forrest
Fortunately	万幸的是
Fortunately	幸运的
Fortunately	所幸
Fortune	财富
Foster	Foster
Foundation	Foundation
Fox	Fox
Franco	佛朗哥
Frank	Frank
Frank	弗兰克
Frankie	Frankie说
Fred	弗雷德
Freeman	Freeman
Friedman	Friedman
Friedman	弗里德曼
Frigoris	冷海
Full	Full
Fund	Fund
Gaga	Gaga
Gail	盖尔
Galileo	伽利略
Galvao	Galvao
Gandhi	甘地
Ganesh	格涅沙
Gansky	甘思琪
Gap	Gap
Gapminder	Gapminder
Garik	Garik
Gary	Gary
Gas	气体
Gates	盖茨
Gayle	盖尔
Geert	海尔特
Gehry	盖瑞
Gehry	盖里
Gene	Gene
General	General
Geoff	Geoff
Georg	Georg
George	George
George	乔治
Georges	Georges
Georgette	Georgette
Georgia	在格鲁吉亚
Germany	德国
Gero	Gero
Gilbert	Gilbert
Gilbert	吉尔伯特
Gillian	Gillian
Girl	女孩
Give	Give
Glenn	格伦
Glennie	Glennie
Global	Global
Gloria	Gloria
Glucksberg	Glucksberg
Golesworthy	Golesworthy
Goodbye	再见
Goodwin	卡恩斯
Google	Google
Gordon	Gordon
Gordon	戈登
Gould	古尔德
Graham	Graham
Grandin	坦普
Grandin	葛兰丁
Grandmother	云外婆
Graph	Graph
Green	Green
Greg	Greg
Greg	格雷格
Grey	Grey
Griscom	格里斯科姆Rufus
Gross	Gross
Guardian	卫报
Guilt	内疚
Gunsmoke	荒野大镖客
Gupta	Gupta
Guthrie	Guthrie
Guy	男子
Guys	各位
Haas	Haas
Hadyn	Hadyn
Haidt	海特
Hall	Hall
Halla	海拉
Hallelujah	哈利路亚
Hallelujah	哈里路亚
Hamlet	哈姆雷特
Han	Han女士
Hans	Hans
Hansen	Hansen
Hanson	汉森
Harald	Harald
Hardy	Hardy
Haring	Harding
Haring	Haring
Harmony	和谐是一件
Harris	Harris
Hasan	哈桑
Hawa	Hawa
Hawkins	Hawkins
Hayes	Hayes
Hazrat	Hazrat
Heatherwick	赫斯维克
Heifer	小母牛
Heinrich	海因里希
Helen	海伦
Hello	你好
Hello	喂
Help	救救我
Hendry	Hendry
Henry	Henry
Henry	亨利
Herbie	Herbie
Herman	Herman
Heroes	女人是英雄
Hertz	赫兹
Hey	嗨
Hey	嘿
Hikuleo	黑酷雷
Hill	Hill
Hillary	希拉里
Hillel	Hillel
Himba	我是辛巴族人
Hindenburg	兴登堡号
Hindi	印度语
Hiroshi	Hiroshi
Hobbes	Hobbes
Hodge	霍奇
Hole	Hole
Holiness	教皇陛下
Home	家园
Homer	Homer
Hong	Hong
Host	主持人
Howard	霍华德
Huck	哈克
Huck	然后哈克说
Hugo	雨果
Humanity	Humanity
Hunter	亨特
Huntington	亨廷顿厨房
Hussein	侯赛因
Hyperscore	超级乐谱
IDEO	IDEO
IMF	国际货币基金组织
Ian	伊恩
Ice	Ice
Idaho	爱达荷州
Idleness	闲置的散文
Iliad	伊利亚特
Image	Image
Image	经图片所有人要求
Imagine	想象一下
Imam	伊玛目费思勒
India	印度
Indonesia	印度尼西亚
Ines	Ines
Internet	Internet
Internet	互联网
Interviewer	记者
Inverleith	Inverleith
Invest	投入
Ishijima	Ishijima
Itay	Itay
Ivan	Ivan
Jabbar	贾巴尔
Jacek	Jacek
Jack	J
Jack	Jack
Jackson	Jackson
Jackson	杰克逊
Jacobson	Jacobson
Jacqueline	Jacqueline
Jacqueline	杰奎琳
Jacqueline	贾桂林
Jacques	Jacques
Jagessar	Jagessar
Jahangir	Jahangir所做的
Jaime	Jaime
Jake	杰克
Jamaica	牙买加
Jamais	Jamais
James	James
James	詹姆斯
Jami	Jami
Jamie	Jamie
Jamii	Jamii
Jane	Jane
Jane	简
Janine	Janine
Janine	詹宁
Japan	日本
Jarrett	Jarrett
Jason	杰森
Jasper	Jasper
Jawbone	颚骨
Jaws	大白鲨
Jay	Jay
Jayant	Jayant
Jeff	Jeff
Jennifer	Jennifer
Jennifer	珍妮佛
Jeremijenko	Jeremijenko
Jerry	Jerry
Jessica	Jessica
Jill	Jill
Jim	Jim
Jim	吉姆
Jimmy	吉米
Joaquin	乔安坤
Jobs	Jobs
Jobs	乔布斯
Jody	茱蒂
Joe	Joe
Joe	这是乔
Joel	Joel
Joey	乔伊
Johanna	Johanna
John	John
John	约翰
Johnny	Jonny
Johns	Johns
Jon	Jon
Jon	乔恩
Jonas	Jonas
Jonathan	Jonathan
Jonathan	乔纳森
Jones	Jones
Jones	琼斯
Jordan	在约旦
Jose	Jose
Joseph	Joseph
Joshua	Joshua
Joubert	Joubert
Juan	Juan
Julia	Julia
Julia	朱莉娅
Julian	Julian
Julie	朱莉
Julius	Julius
Jurvetson	Jurvetson
JusticeMakers	公正缔造者
Kabila	Kabila
Kahle Brewster	Kahle Brewster
Kahn	康恩
Kakenya	Kakenya
Kaki	Kaki
Kaluza	卡鲁扎
Kamen	卡门
Kaminsky	卡明斯基
Kaplan	卡普兰
Kaplan	卡普兰和基斯
Kapur	凯普尔
Karl	Karl
Kartick	Kartick
Kary	Kary
Kate	你拉上凯特
Kate	拉上凯特
Kathryn	凯瑟琳
Katragadda	Katragadda
Kavita	Kavita
Kay	凯
Kazakhstan	哈萨克斯坦
Keep	保留
Keep	继续前进
Keith	Keith
Keller	Keller
Kelly	Kelly
Ken	Ken
Kennedy	Kennedy
Kent	Kent
Kenya	肯尼亚
Kenyon	肯尼娅
Kepler	开普勒
Kevin	Kevin
Khan	Khan
Khanfar	坎法尔
Kick	孩子还是
Kid	Kid
Kids	孩子们
Kiki	Kiki
Kim	Kim
King	路德
Kinko	Kinko
Kinsey	金赛
Kiran	Kiran
Kirk	Kirk
Kirsten	Kirsten
Kismet	Kismet
Kiteflyer	风筝山
Klein	Klein
Knight	奈特
Knowledge	知识就是力量
Koller	Koller
Koran	古兰经
Krishna	他终会化为罗摩重生
Krishnan	Krishnan
Krosoczka	Krosoczka
Kuhn	Kuhn
Kuiken	库伊肯
Kuriyama	Kuriyama
Kurstin	Pamelia
Kurzweil	Kurzweil
Kwabena	Kwabena
LXD	LXD
LXD	杰出舞蹈家组成的舞蹈团
Labs	Labs
Lacus	拉克丝
Ladies	女士们
Lagos	一切会变得不同吗
Lalitesh	Lalitesh
Lampoon	国家讽刺周刊
Langley	Langley
Larry	Larry
Larson	Larson
Lauren	劳伦
Laurie	Laurie
Laws	简洁的法则
Lazarus	Lazarus
Leah	Leah
Leahy	Leahy
Leakey	Leakey
Lebanon	他在黎巴嫩
Lee	李
Legadema	Legadema
Legato	Legato
Lemn	Lemn
Leo	里昂
Lesotho	在莱索托
Levin	Levin
Levin	莱文
Levine	Levine
Leviticus	利未记
Levitt	Levitt
Lewis	Lewis
Lewis	刘易斯
Lewis	路易斯
Liabhan	Liabhan
Libation	奠酒
Libeskind	Libeskind
Licklider	Licklider
Liespotting	识破谎言
Lil	Lil
Limb	Limb
Lincoln	林肯
Lindbergh	林德伯格
Lindsey	林赛
Linux	Linux
Lisa	丽莎
Listen	听
Listen	听着
Live	Live
Lloyd	Lloyd
Lock	Lock
Long	Long
Lothar	梅根多尔弗尔
Lotto	Lotto
Louis	路易
Louise	Louise
Lovegrove	Lovegrove
Lovelace	Lovelace
Lovins	Lovins
Lucy	露西
Luke	路克
Lush	怒放的生命
Lynch	Lynch
Lynn	Lynn
Lynne	Lynne
Maajid	马吉德
MacArthur	MacArthur
MacCready	麦克柯罗迪
MacMaster	MacMaster
Macaulay	Macaulay
Machine	Machine
Machover	Machover
Madagascar	马达加斯加
Madeleine	马德琳
Madoff	麦道夫
Madrid	在马德里
Maestro	大师
Magic	魔术
Maira	Kalman
Majesty	陛下
Majora	梅杰拉
Mali	马里
Mallika	Mallika
Man	男人
Mandela	曼德拉
Mapmaker	Mapmaker
Marc	Marc
Marcel	Marcel
Marco	马可
Marcus	马库斯
Margaret	Margaret
Margaret	玛格丽特
Marie	玛丽
Marisa	Marisa
Marissa	玛丽莎
Mark	Mark
Mark	马克
Markham	Markham
Marshall	马歇尔
Martin	马丁
Mary	玛丽
Mash	Mash的
Mathieu	Mathieu
Matrix	黑客帝国
Matt	Matt
Max	Max
May	五月
Mayassa	Mayassa
Maz	马兹
McCloud	司考特
McDonald	麦当劳
McDonough	McDonough
McGonigal	McGonigal
Mechai	Mechai
Media	Media
Meggendorfer	罗萨
Mello	Mello
Metrics	度量
Michael	Michael
Microsoft	Microsoft
Mike	Mike
Mikey	迈克
Miklos	米克罗斯
Miko	麦可
Milky	银河系
Miller	Miller
Milo	米洛
Minsky	Minsky
Mistry	Mistry
Mitchell	Mitchell
Mitchell	米切尔
Mitra	Mitra
Mobs	同党
Mobutu	Mobutu
Moderator	主持人
Mohamed	Mohamed
Mohr	Mohr
Mola	Mola
Moldova	在摩尔多瓦
Moleeds	莫利德
Mom	妈妈
Mommy	妈咪
Mons	Mons
Montage	剪辑
Monterey	蒙特里
Moore	Moore
Moore	摩尔
Morgan	Morgan
Moses	摩西
Moshe	Moshe
Mother	母亲
Mother	特蕾莎修女
Mounds	山丘
Mozart	莫扎特
Mracek	姆拉切克
Muhammad	穆罕默德
Mullainathan	穆拉伊特丹
Mullins	穆林斯
Mullis	Mullis
Muniz	Muniz
Muriel	穆里尔
Murmurs	悄悄话
Murphy	摩尔菲
Murray	穆雷
Muruganantham	Muruganantham
Must	必须
Mwenda	Mwenda
Myhrvold	梅尔沃德
Méliès	梅里爱
NAND	NAND
NASA	NASA
NGOs	非政府组织
NIH	NIH
Nadia	Nadia
Naif	纳伊夫
Nalini	Nalini
Namaste	那马斯特
Name	Name
Nanny	保姆
Nano	Nano
Narration	旁白
Narrator	旁白
Natalie	Natalie
Natasha	Natasha
Natasha	娜塔莎
Nathan	Nathan
Nathan	内森
Nathaniel	纳撒尼尔
Nature	自然
Nawaz	纳瓦兹
Nazism	纳粹主义
Needless	不用说
Needs	Needs
Neil	Neil
Neil	尼尔
Nelson	尼尔逊
Neshat	Neshat
Netflix	Netflix
Netherlands	在荷兰
Network	Network
New	New
Newsweek	新闻周刊
Newton	牛顿
Niall	吉尤萨尼
Niall	尼尔
Nicaragua	尼加拉瓜
Nicholas	尼古拉斯
Nick	Nick
Nick	尼克
Nicole	Nicole
Nigel	奈吉尔
Noah	诺亚
Noise	Noise
Nolan	Nolan
Nollywood	尼莱坞
None	一个也没有
Noora	Noora
Nope	算了
Nora	劳拉
Norden	诺顿
Norman	Norman
Norman	诺曼
Norris	Norris
Norse	五点构架
Norway	挪威
Noujaim	妮珍儿
November	十一月
Novogratz	Novogratz
Novogratz	诺沃格拉茨
Now	现在
Ntaiya	Ntaiya
Nutmeg	肉豆蔻
OED	OED
OLPC	OLPC
OMG	OMG
Oblivion	遗忘
October	十月
Office	Office
Oil	Oil
Okapi	Okapi
Okay	好的
Oliver	Oliver
Olympus	Olympus
One	一
Onicha	欧尼卡
Open	Open
Open	打开
Oportunidades	机遇
Opportunity	机会
Orgel	奥杰尔第二定律
Origins	源头
Orkut	是Orkut
Ory	Ory
Oscar	奥斯卡
Out	外面
Owl	猫头鹰
PCBs	多氯联苯
PEPFAR	PEPFAR
PETA	善待动物组织
PJC	PJC
PSA	前列腺特异抗原
Page	Page
Pagel	佩格尔
Palin	Palin
Pallotta	Pallotta
Panisse	Panisse
Paola	Paola
Parry	Parry
Part	部分原因是
Participant	参与者制作公司
Party	Party
Pascal	法国数学家
Pat	Pat
Patel	Patel
Patient	病患
Patricia	Patricia
Patricia	帕特里夏
Patrick	Patrick
Patton	Patton
Paul	Paul
Paul	保罗
Pavan	Pavan
Pearl	珍珠母
Penelope	Penelope
Pepper	Pepper
Per	Laptop
Perel	Perel
Perfect	好极了
Perfect	完美
Perry	Perry
Pete	Pete
Peter	Peter
Peter	彼得
Philip	菲利普
Philippe	Philippe
Philippe	菲利普
Philippines	菲律宾
Phillips	Phillips
Phoenix	Phoenix
Phone	电话
Photoshop	Photoshop
Phyllis	菲莉斯
Piazzolla	皮亚佐拉的
Piccard	Piccard
Picchu	Picchu
Pick	请做选择
Pierre	皮埃尔
Pink	Pink
Pink	粉色球
Pinker	Pinker
Pisani	Pisani
Plato	柏拉图
Playboy	花花公子
Pleo	Pleo
Plus	Plus
Pogue	Pogue
Point	Point
Poland	波兰
Policy	Policy
Pollock	Pollock
Poole	Poole
Pope	Pope
Portugal	葡萄牙
Portugal	阿尔瓦罗
Power	Power
Powers	Powers
Pragmatic	Pragmatic
Prakash	普拉卡
Pranav	Pranav
Pranitha	Pranitha
Prego	Prego
Preston	Preston
Prince	小王子
Prince	王子
Print	印刷的终结
Prize	Prize
Professor	教授
Punk	朋克庄园
Puppy	狗狗
Queensland	昆士兰州
Quincy	Quincy说
Quyen	Quyen
RCA	RCA
ROD	ROD
RSW	乌尔曼
Rachel	瑞秋
Radcliffe	拉德克利夫
Radio	无线电
Rajesh	Rajesh
Ralph	Ralph
Ram	奎师那就诞生了
Ramachandran	Ramachandran
Rand	兰德
Rani	Rani
Rao	Rao
Raqs	Raqs
Rare	Rare
Rasmussen	Rasmussen
Ravilla	Ravilla
Ray	Ray
Reach	Reach
Ready	准备好了吗
Really	真的么
Rebecca	Rebecca
Recorded	录音
Recording	录音
Records	吉尼斯世界纪录
Redwood	安东尼
Reed	Reed
Rem	Rem
Rendering	渲染
Resnick	雷斯尼克
Resolute	坚决
Riaz	Riaz
Richard	Richard
Richard	理查德
Richter	Richter
Rick	Rick
Ridley	瑞德里
Right	对吧
Right	对吗
Rinaudo	Rinaudo
Ritchie	Ritchie
RoMeLa	RoMeLa
Road	在路上
Rob	Rob
Robert	Robert
Robot	机器人
Robotic	Robotic
Rockett	罗基特
Rockwell	Rockwell的作品
Roger	罗杰
Rogers	Rogers
Romo	Romo
Ron	Ron
Roosevelt	罗斯福
Roots	根与芽
Rory	Rory
Rory	罗里
Rose	Rose
Rosie	若斯
Rosling	Rosling
Ross	Ross
Rossy	罗西
Rossy	罗西来了
Rothemund	Rothemund
Rover	Rover
Rowe	Rowe
Roy	罗伊
Roz	罗兹
Ruby	Ruby
Rufus	鲁弗斯
Rughal	卢加尔
Rumi	鲁米
Rupert	Rupert
Russert	路塞特
Russia	俄罗斯
Rutan	鲁坦
SOC	Chinoy
Sacks	萨克斯
Saddam	萨达姆
Sagmeister	Sagmeister
Saint	Saint
Salman	Salman
Sam	Sam
Sam	山姆
Samantha	Samantha
Samuel	塞缪尔
San	San
Sanjay	Sanjay
Sarabhai	Sarabhai玛利卡
Sarah	莎拉
Saraswati	Saraswati
Satan	撒旦
Saturn	土星
Saunders	桑德斯
Savage	萨维奇
Savory	Savory
Scared	害怕
Schocken	Schocken
Schocken	Schocken西蒙
Schuler	Schuler
Schulz	舒尔茨
Schwaitzberg	史威茨博格
Scott	Scott
Scott	斯科特
Scott	这是Scott
Sean	Sean
Sean	肖恩
Sebastian	Sebastian
Second	第二点
Secret	秘密
Secrets	秘密可以是多种多样的
Seed	Seed
Sendhil	森德希尔
Sergey	Sergey
Seth	Seth
Sethi	Sethi
Seung	Seung
Shake	再摇一下
Shakespeare	莎士比亚
Shame	羞耻
Shankar	Shankar
Shannon	Shannon
Sharon	Sharon
Shawn	肖恩
Sheena	希娜
Sheikha	Sheikha
Sheila	Sheila
Shekhar	谢加
Shereen	Shereen
Shermer	Shermer
Sherry	Sherry
Shhh	嘘
Shimon	Shimom
Shimon	Shimon
Shirin	Shirin
Shiv	Shiv
Show	Show
Shree	斯里
Shukla	Shukla
Shush	嘘
Shut	闭嘴
Similarly	相似地
Similarly	类似的
Simpson	Simpson
Singapore	新加坡
Singer	歌手
Sissay	Sissay
Sistema	Sistema
Sit	坐下
Sitopia	希托邦
Skycar	飞天车
Skylar	斯凯拉
Skylife	巴拉奎史南的
Skype	Skype
Slavery	Slavery
Slavery	奴隶制
Sleep	睡眠
Small	小
Smile	微笑
Smith	Smith
Smith	斯密
Smooth	Smooth
Snowball	雪球
Soap	肥皂
Soldier	士兵
Somalia	索马里
Someday	总有一天
Sometimes	有时候
Soon	不久以后
Sorry	不好意思
Sorry	对不起
Sorry	抱歉
Sousa	Sousa
Sousa	苏萨
Spades	黑桃
Specifically	特别的
Spencer	Spencer
Spiderman	蜘蛛侠
Spinternet	贴金网
Spring	Spring
Sputnik	人造卫星
Squash	去踩扁它
Stacy	Stacy
Stamets	Stamets
Stanley	Stanley
Stanley	斯坦利
Star	Star
Starck	Starck
Stavridis	Stavridis
Steel	Steel
Stefan	Stefan
Stefan	斯蒂芬
Step	第三步
Stephen	Stephen
Stephen	史蒂芬
Stern	Stern
Steve	Steve
Steve	史蒂夫
Steven	Steven
Steven	史蒂芬
Stewart	Stewart
Stewart	斯图尔特
Stone	Stone
Stone	斯通
Stop	停
Strudwick	Strudwick
Stuart	Stuart
Stuart	斯图尔特
Student	学生
Stumbling	撞上快乐
Suddenly	突然
Sugata	Sugata
Sung	Sung
Sunitha	Sunitha
Surely	想必
Susan	Susan
Susan	苏珊
Susie	黑眼睛的苏茜
Sutherland	Sutherland
Svalbard	在斯瓦尔巴
Swaptree	Swaptree
Sweeney	Sweeney
Sweeney	斯文内
SymbioticA	SymbioticA
TACARE	关爱
TBP	TBP
TED	TED
TEDGlobal	TEDGlobal
TEDWomen	TEDWomen
TEDxFeatured	TEDxFeatured
THE	THE
Tabar	Tabar
Tahltan	塔尔坦人
Tal	Tal
Talks	Talks
Taylor	泰勒
Ted	Ted
Tembererana	弹拨若然娜
Tempest	坦布斯特
Temple	坦普
Tendai	Tendai
Terkel	Terkel
Terrorists	恐怖分子
Terry	Terry
Terry	特里
Teszler	特兹勒先生
Text	字幕
Text	文字
Thailand	在泰国
Thaler	泰勒和我
Thandie	桑迪
Theodoor	西奥多
Theodore	Theodore
Thomas	Thomas
Thomas	托马斯
Three	三
Thulasiraj	Thulasiraj
Thurman	瑟曼说
Tibbits	蒂比茨
Tiger	拯救老虎计划
Tilson	蒂尔森
Tim	Tim
Tim	提姆
Tim	蒂姆
Timothy	Timothy
Titanic	泰坦尼克
Titanic	泰坦尼克号
Titian	酒神祭
Todd	托德
Together	合
Tokyo	东京
Tom	Tom
Tommy	Tommy
Toomey	Toomey
Torture	折磨
Toughness	强悍
Tourist	游客
Tower	Tower下面
Tower	加拿大议会大楼
Trains	火车
Transparency	透明国际
Treasure	Treasure
Tristram	崔斯特瑞姆
Trott	Trott
True	真实
Trust	信任
Tulles	Tulles
Turkey	土耳其
Turkle	Turkle
Twain	吐温
Two	二
Typically	一般来说
Tyrone	Tyrone
Ueli	Ueli
Uganda	乌干达
Ulbrich	Ulbrich
Uniview	宇宙观探
Upwake	觉醒
Ursonate	声音诗歌
Ursus	Ursus
Uruguay	乌拉圭
Ushahidi	Ushahidi
Usman	Usman
Utko	Utko
Valenti	Valenti
Van	Van
Van	范
Vander	Vander
Vannevar	范尼瓦尔
Vashem	Vashem
Venter	Venter
Venture	Venture
Verinsky	Verinsky
Verizon	Verizon
Vertes	韦尔泰什
Viagra	伟哥
Video	视频
Video	记录片
Vik	Vik
Vikram	Vikram
Viravaidya	Viravaidya
Vivre	vivre
Voice	声音
Vusi	乌瑟
WITNESS	目击者
Wadah	瓦达
Wael	瓦埃勒
Walker	Walker
Walker	汤普森
Wall	Wall
Wallace	瓦伦斯
Walsingham	Walsingham
Walton	沃顿
Ward	Ward
Warren	Warren
Warren	沃伦
Washburn	沃什伯恩
Watt	Watt
Weathers	Weathers
Weetjens	Weetjens巴特
Wehrli	Wehrli
Wells	Well
Whatever	无论是什么
Whatever	管他呢
Whitley	Whitley
Whitney	惠特尼
Whole	Whole
Why	为什么
Widder	维达
Wigan	威根
WikiLeaks	维基揭密
Will	威尔
Willard	维拉德
William	William
William	威廉
Williams	Williams
Willis	Willis
Wilson	Wilson
Wilson	威尔逊
Wired	连线
Wisdom	人群的智慧
Within	Within
Wizard	绿野仙踪
Wolfram	Wolfram
Woman	女人
Woman	女士
Woody	Woody
Words	言语离去了
World	World
Wow	哇
Wright	Wright
Wrong	错
Wurman	沃尔曼
YAB	伯特兰
Yad	Yad
Yann	扬恩亚瑟伯特兰Yann
Yay	耶
Yeah	是的
Yes	是的
Yesterday	昨天
Yossi	Yossi
Young	Young
YoungmeNowme	年轻的我现在的我
Yours	你的世界
Yves	Yves
Yves	伊夫斯
Zach	扎克
Zambia	在赞比亚
Zambia	赞比亚
Zappos	Zappos
Zem	泽姆
Zimbabwe	在津巴布韦
Zimbardo	Zimbardo
Zoe	穗
Zuckerberg	扎克伯格
accessible	可获取
achievement	这是多大的成就
activism	activism
adaptability	这就是适应性
adventure	adventure
aesthetics	美学
afternoon	一天下午
afterwards	演讲结束后
agenticity	造神
aging	aging
agriculture	agriculture
ahn	ahn
aircraft	aircraft
aka	亦称
alan	alan
alcohol	酒精
alternative	alternative
amar	亚玛
amy	amy
anderson	anderson
angels	天使
anger	愤怒
animals	animals
anna	anna
anthropology	anthropology
antiangiogenic	反血管增生疗法
antidepressants	antidepressants
apartheid	种族隔离
apes	apes
apps	apps
architecture	architecture
arithmetic	算术
art	art
arthritis	关节炎
articles	的文章
artists	艺术家
arts	arts
ascent	人的升华
ashamed	别害羞
ashamed	这没有什么好羞耻的
asia	asia
asthma	哮喘
astronomy	astronomy
atheism	atheism
athletes	运动员
attachment	和依赖
autonomy	自治
avatar	阿凡达
balanced	平衡
bang	bang
bang	砰
bankers	银行家
barley	甜菜头
barry	barry
basically	基本上
bears	熊
beauty	beauty
behavioral	behavioral
believes	前者相信人生仅此一次
ben	ben
benjamin	benjamin
beware	beware
bill	bill
biodiversity	biodiversity
biology	biology
biomaterials	加上生物材料
biomechanics	biomechanics
biomimicry	biomimicry
biosphere	biosphere
biotech	biotech
bite	就一口
bless	上帝保佑他们
blindfold	我会带上遮眼布
blink	眨眼
blogger	我是个写博客的人
blogs	博客
blue	blue
boca	boca
boots	七联赛靴
botany	botany
brain	brain
brian	brian
brown	brown
bruce	bruce
business	business
butterflies	蝴蝶
bye	bye
carbs	好的碳水化合物
care	care
careful	要小心
caregivers	和护理人员
cares	谁会在乎
carolyn	carolyn
carter	carter
ceiling	挂在天花板上
cello	cello
certainty	确定性
cesar	cesar
chairs	椅子
change	change
charged	带电粒子
charles	charles
charter	charter
chatting	聊天
chautauqua	chautauqua
chef	厨师
chemistry	chemistry
children	children
china	china
chitra	Chitra
chk	哧
chris	chris
christopher	christopher
churches	教堂
cigarettes	香烟
cities	cities
clapping	他们在鼓掌
climate	climate
cocaine	可卡因
cogito	cogito
cognitive	cognitive
coincidence	这不是巧合
collaboration	collaboration
collectors	收藏家
colonies	的蜂群
comedy	comedy
communicate	来交流
communication	communication
community	community
compared	和亚洲相比
compared	的人恢复健康
compassion	compassion
compassion	同情
competition	没有竞争者
complexity	complexity
complexity	复杂
composing	composing
compromise	妥协
computers	computers
computing	计算
concrete	水泥
condom	安全套
condoms	避孕套
connectome	连接体
consciousness	consciousness
consequences	无论结果如何
consumer	消费者
consumerism	consumerism
consumers	消费者
contrast	相对的
conventional	传统的
cooperation	cooperation
corruption	corruption
cosmos	cosmos
council	爸爸军团
courage	勇气
crabs	螃蟹
cradle	从摇篮到摇篮
creativity	creativity
crime	crime
crocodile	鳄鱼
culture	culture
curiosity	curiosity
cybertopians	网托邦
cyborg	cyborg
cynical	媚俗设计
dan	dan
dance	dance
daniel	daniel
dave	dave
david	david
dean	dean
deflation	的价格下降
demo	demo
demos	demos
denial	否认
dennis	dennis
des	des
design	design
detection	我们要早发现
detection	早发现
development	development
diabetes	糖尿病
diarrhea	痢疾
digs	digs
dilemmas	邪恶
dining	餐厅
diplomacy	外交手腕
disability	disability
disappear	消失
disappearing	正在消失
disaster	disaster
disease	disease
disincentive	它抑制了对水源的保护
divorce	离婚
dna	dna
doctors	医生
dragons	龙
drama	有戏剧效果的是
driver	驾驶座
drunk	威廉福克纳
dum	dum
dumpster	扔掉
earthquakes	地震
economics	economics
editors	编辑
education	education
effectively	非常有效
electron	电子
elizabeth	elizabeth
ellen	ellen
emancipation	解放
emptiness	空
encouragement	鼓励
energy	energy
engineering	engineering
engineers	工程师
entertainment	entertainment
entrepreneur	entrepreneur
environment	environment
epidemiology	epidemiology
erectus	直立人
eric	eric
estimated	据估计
eureka	我发现了
evolution	evolution
exams	考试
explaining	向他们解释
exploration	exploration
extreme	extreme
facial	表情
faith	faith
faiths	仁爱之心
famine	饥荒
fed	运输
feelings	感觉
fights	fights
figments	幻象
film	film
finance	金融
fish	fish
fisher	fisher
flight	flight
food	food
forced	forced
forests	森林
fortunately	幸运地是
fourth	第四
frank	frank
frankly	坦白说
freedom	自由
friendship	友情
frugality	节俭
fuck	去他的
future	future
gaga	Gaga
gaga	gaga
gaming	gaming
gender	gender
generally	一般来说
genetics	genetics
genius	天才
genocide	种族屠杀
gentlemen	先生们
geoff	geoff
geology	geology
george	george
giraffe	长颈鹿
glibness	口若悬河
global	global
globalization	全球化
gosh	我的天哪
gossip	八卦
governor	总督说
graham	graham
grant	grant
gravity	重力
green	green
greenhouse	温室效应
gregory	gregory
grief	悲伤
growth	growth
guilt	内疚
guitar	guitar
guts	勇气
hack	hack
haiti	haiti
hans	hans
happiness	happiness
harris	harris
headquarters	总部
health	health
helen	helen
helicopters	直升机
heroism	heroism
hesitated	我犹豫了
hey	嘿
hire	你需要雇佣很专业人员
history	history
hiv	hiv
homework	家庭作业
homunculus	矮人
honey	亲爱的
hong	hong
housing	住房
http	http
humanity	humanity
humor	humor
hypertension	高血压
iPhone	iPhone
iPod	iPod
ibuprofen	ibuprofen
ideal	在一个完美的世界
ignostic	忽视主义者
illiteracy	文盲
illness	illness
illusion	illusion
impatients	没有耐心的人们
impenetrability	不可渗透性
importantly	但是更重要的是
importantly	而且更重要的是
industrial	industrial
infected	传染
infinity	无限
innovation	innovation
insects	insects
integrity	正直
intelligence	intelligence
interestingly	很有趣的是
interface	interface
interview	interview
invention	invention
investing	investing
investment	investment
iraq	iraq
ironically	讽刺的是
issues	issues
jack	J
jackson	jackson
jails	有些工作是监狱
james	james
jane	jane
jason	jason
jaw	下巴
jennifer	jennifer
jewelry	珠宝
john	john
jonathan	jonathan
jones	jones
joshua	joshua
journalism	journalism
julian	julian
justice	公正
kathryn	kathryn
kelly	kelly
ketchup	番茄酱
kevin	kevin
kick	踢
kidneys	肾脏
killer	killer
kings	国王
knocked	敲了敲门
labeled	的标签
ladies	女士们
lamb	把它压在柱子上
language	language
larry	larry
laughed	我笑了
laughter	很多笑声
law	law
lawyers	律师
leadership	leadership
leadership	领导力
libraries	图书馆
library	library
literature	literature
live	live
liver	肝脏
location	位置
loser	失败者
luck	祝你好运
luckily	但幸运的是
macmaster	macmaster
magazine	杂志
magic	magic
magnetic	magnetic
makers	我们是创造者
malaria	疟疾
malnutrition	营养不良
mama	妈妈
marketing	marketing
marks	X标记点
martin	martin
mate	伙计
materials	materials
math	math
mckay	mckay
media	media
medical	medical
medicine	medicine
meditation	在冥想中
meme	meme
menus	菜单
merchants	商人
meritocracy	功绩主义
meritocratic	功绩主义
metabolism	新陈代谢
methane	甲烷
michael	michael
microbiology	microbiology
microbiology	微生物学
microfinance	microfinance
millennia	数千年来
miracle	真是个奇迹
mission	mission
mobilize	在这方面投资
mola	mola
mop	厨房水
morality	morality
morality	道德
muffin	muffin
mulgan	mulgan
museums	museums
music	music
mutilate	残害
nails	指甲
nanoscale	nanoscale
nanotechnology	纳米技术
napot	napot
natalie	natalie
naturally	很自然
naturally	自然地
nausea	恶心
neil	neil
nellie	nellie
neurology	neurology
neuroscience	neuroscience
newspapers	报纸
nicholas	nicholas
nicotine	尼古丁
noisy	噪音
non	non
novels	小说
nuns	神父
nurses	护士
nusha	纳莎
nutrition	营养
obsolete	过时了
oceans	oceans
opera	歌剧
opportunities	机会
opposite	恰恰相反
optimistic	我对此非常乐观
origami	折纸
origins	origins
ornish	ornish
orphan	她是个孤儿
overboard	放弃或摆脱
overfishing	过度捕捞
oxide	亚硝酸盐
oysters	牡蛎
pacak	pacak
packaging	包装
paleontology	paleontology
parachute	降落伞
paralysis	习得行麻痹
parenting	parenting
partner	partner
passenger	乘客
pathology	不可避免的死亡
patricia	patricia
patrick	patrick
paul	paul
peace	peace
peaceful	和平
penelope	penelope
penis	penis
performance	performance
peripeteia	peripeteia
peripetia	转折
permanent	永久的
personal	personal
peter	peter
pets	宠物
pets	牲畜和宠物
phenomenal	太神奇了
phil	phil
philanthropy	philanthropy
philosophy	philosophy
photography	photography
photons	光子
physics	physics
piano	piano
planning	planning
plants	植物
plastic	plastic
playful	好玩吗
plays	plays
plot	情节
plotted	同理制表
poetry	poetry
poets	诗人
policies	政策
politician	政治家
politicians	政治家
politics	politics
pollution	pollution
pollution	污染
possibilities	可能
potatoes	土豆
poverty	poverty
prediction	prediction
presentation	presentation
previews	previews
priests	神父
primates	primates
primates	在灵长类动物中
prodigy	prodigy
product	product
productivity	productivity
productivity	生产力
products	产品
profit	利润
pronounced	念
prosthetics	prosthetics
proteins	蛋白质
proteomics	蛋白质组学
protocell	原生细胞
psychic	职业灵媒师
psychology	psychology
psychopath	典型的精神病患者
pyramids	金字塔
quadrillion	一千万亿
quantity	我要的是数量
quarks	夸克
quest	quest
quotes	妙语
race	race
rachel	rachel
rain	rain
randomized	随机的
reads	reads
rebellion	反抗
reflex	reflex
regrows	它会再长出来
relationships	relationships
relax	放松
relief	relief
religion	religion
repeat	我再重复一遍
reply	他们问我为什么教书
resplendent	辉煌
restaurants	餐馆
restaurants	饭店
rethinks	rethinks
retrospect	回想起来
reveals	reveals
richard	richard
rider	它得有个骑士
right	对吧
rob	rob
robert	robert
robotics	机器人技术
robots	robots
rocket	rocket
rory	rory
rosling	rosling
roughness	粗糙
sadness	悲伤
safer	更安全
sagmeister	sagmeister
sale	出售
sang	他唱到
sanitation	卫生设施
sarah	sarah
scaffolds	模子
schizophonia	幻听
schulz	schulz
science	science
self	self
sensitive	非常敏感
sensors	传感器
serotonin	血清素
seth	seth
settle	停下来
sex	sex
shannon	shannon
shares	shares
sharks	还有鲨鱼
sharks	鲨鱼
shelter	住所
shopping	shopping
short	short
shortcuts	捷径
significance	重要性
simon	simon
simplicity	simplicity
simplicity	什么事简洁
simplicity	简洁
singer	singer
sings	sings
singularity	singularity
sir	先生
sir	这位先生
sisters	姐妹
slaves	奴隶
smallpox	天花
smarter	更聪明
smasher	球棍型
smoke	烟
snake	蛇
snakes	蛇
social	social
society	society
sociology	社会学
soft	软
software	software
soluble	问题是可以解决的
someday	总有一天
somehow	不知何故
sometimes	有时候
sonicate	声处理
sorry	对不起
south	south
space	space
spades	黑桃
spoken	spoken
sports	sports
squared	平方
staples	订书针
statistics	statistics
status	status
status	身份
stefan	stefan
stephen	stephen
steve	steve
steven	steven
stewart	stewart
stomach	胃
storytelling	storytelling
studies	studies
stylish	我处于半疯狂中
subtext	言外之意
success	success
sucks	生活糟透了
superorganism	超级生物体
surfboards	冲浪板
sustainability	sustainability
symbols	象征
symphonies	交响乐
sync	同步
synesthesia	共感
talk	talk
talks	talks
teachers	老师
tech	tech
technically	技术上来说
technicians	技术人员
technologists	科技人员
technology	technology
ted	ted
tedbooks	tedbooks
tedx	tedx
telecom	telecom
teleconferencing	电话会议
temperature	温度
terabytes	TB
texting	发短信
theater	theater
thinks	thinks
third	third
thirdly	第三点
thomas	thomas
thrived	发了
thrived	发财了
throve	发了
throve	发财了
throwaway	用完就扔
tiger	老虎
tim	tim
tom	tom
tonight	今晚
totalitarian	极权主义
traditionally	传统上
trafficking	trafficking
transformation	第一个转型
transhuman	transhuman
transit	公共交通
transparency	透明
transparent	透明化
transportation	transportation
trumpet	喇叭
unbelievable	真是难以置信
uncle	叔叔
unclear	不清楚
underwater	在水下
undesirable	一致性是不可取的
uniformity	在一切事物中
unite	联合起来
universe	universe
uploading	讲电话
urban	urban
van	van
van	范
variation	的差异
violence	violence
violin	violin
visualizations	visualizations
vitality	活力
vocals	vocals
voluntary	它是自愿的
von	von
war	war
web	web
websites	网站
wetlands	湿地
whistle	吹口哨
whistled	吹口哨
whitesides	whitesides
wholeness	完整
wikipedia	wikipedia
williams	williams
women	women
workarounds	基于周遭问题
wright	wright
writer	作家
writing	writing
wunderkind	wunderkind
xenophiles	异国癖
younger	年轻人
youth	youth
zoning	分区
